00000000000000000000
00000000000000000000
00000000000000000000
00000000000000000000
00000011100000000000
00000014100000000000
00000010100000000000
00000010100000000000
00000010111111000000
00011112020041000000
00014002311111000000
00011111210000000000
00000001010000000000
00000001010000000000
00000001410000000000
00000001110000000000
00000000000000000000
00000000000000000000
00000000000000000000
00000000000000000000
