00000000000000000000
00000000000000000000
00000000000000000000
00000000000000000000
00000000000000000000
00000011111000000000
00000013001000000000
00000010221011100000
00000010201014100000
00000011101114100000
00000001000004100000
00000001001000100000
00000001001111100000
00000001111000000000
00000000000000000000
00000000000000000000
00000000000000000000
00000000000000000000
00000000000000000000
00000000000000000000
