00000000000000000000
00000000000000000000
00000000000000000000
00000000000000000000
00000000000000000000
00000000000000000000
00000000011111000000
00000001110001000000
00000011000121000000
00000010011001000000
00000010200001000000
00000013011201000000
00000011114441000000
00000000011111000000
00000000000000000000
00000000000000000000
00000000000000000000
00000000000000000000
00000000000000000000
00000000000000000000
