00000000000000000000
00000000000000000000
00000000000000000000
00000000000000000000
00000000000000000000
00000000111110000000
00000000130410000000
00000000121010000000
00000000100010000000
00000011101010000000
00000010020410000000
00000010240010000000
00000011111110000000
00000000000000000000
00000000000000000000
00000000000000000000
00000000000000000000
00000000000000000000
00000000000000000000
00000000000000000000
