00000000000000000000
00000000000000000000
00000000000000000000
00000000000000000000
00000000111100000000
00000001100110000000
00000001020010000000
00000001002010000000
00000001114010000000
00000000014010000000
00000000014110000000
00000001114010000000
00000001020310000000
00000001002010000000
00000001000110000000
00000001111100000000
00000000000000000000
00000000000000000000
00000000000000000000
00000000000000000000
