00000000000000000000
00000000000000000000
00000000000000000000
00000000000000000000
00000000000000000000
00000000111100000000
00000001144100000000
00000011444100000000
00000011020100000000
00000010202100000000
00000010120110000000
00000010102010000000
00000010000010000000
00000011131110000000
00000000111000000000
00000000000000000000
00000000000000000000
00000000000000000000
00000000000000000000
00000000000000000000
